     #####
######   #
#  $     #
#  $### ##
##.$. . .#
 # $#    #
 # @######
 #  #
 ####