 ####
 #  #
## .###
#  .$ #
#* *  ##
# $.$$ #
#  .   #
###*####
  #@#
  ###