#######################
#      #   #   #      #
# $@$$ # $     # .. ..#
## ## ### ### ### ## ##
 # #       #       # #
 # #   #   #   #   # #
 # ################# #
 #                   #
 #####################