      ####
#######  #
#     * .##
# $$#  *  ##
# $@ #* *  ##
## $ # * *  #
 ### #. * * #
 #   .  #  .#
 #   #  #####
 ########